11111111111111111111111111111111111111111111111111111111111111111111111111111111111111111111111111111111111111111111111111111111
00000000000000000000111111111000000000000000000000000000000000111111111000000000000000000000000000000011111111100000000000000000
00000000000000000000011111110000000000000000000000000000000000011111110000000000000000000000000000000001111111000000000000000000
00000000000000000000001111100000000000000000000000000000000000001111100000000000000000000000000000000000111110000000000000000000
00000000000000000000000111000000000000000000000000000000000000000111000000000000000000000000000000000000011100000000000000000000
00000000000000000000000010000000000000000000000000000000000000000010000000000000000000000000000000000000001000000000000000000000
00000000000000000000000000000000000000000000000000000000000000000000000000000000000000000000000000000000000000000000000000000000
00000000000000000000000000000000000000000000000000000000000000000000000000000000000000000000000000000000000000000000000000000000
00000000000000000000000000000000000000000000010000000000000000000000000000000000000000100000000000000000000000000000000000000000
00000000000000000000000000000000000000000000111000000000000000000000000000000000000001110000000000000000000000000000000000000000
00000000000000000000000000000000000000000001111100000000000000000000000000000000000011111000000000000000000000000000000000000000
00000000000000000000000000000000000000000011111110000000000000000000000000000000000111111100000000000000000000000000000000000000
00000000000000000000000000000000000000000111111111000000000000000000000000000000001111111110000000000000000000000000000000000000
11111111111111111111111111111111111111111111111111111111111111111111111111111111111111111111111111111111111111111111111111111111